15 4 15 7 7 9 10 11 11 7 8 9 10 11 12
15 4 15 7 8 9 10 11 11 7 8 9 10 7 8
15 0 14 15 14 9 11 11 11 7 8 9 10 11 11
15 7 5 7 15 7 7 9 10 11 7 8 7 8 11
15 5 7 5 14 15 15 15 14 9 10 7 8 11 11
15 5 7 5 7 5 7 5 15 9 9 10 11 11 11
14 15 15 15 15 14 7 5 15 9 10 7 8 11 11
7 8 21 10 11 14 14 5 15 9 10 11 11 11 11
10 11 8 10 11 8 15 5 15 9 10 7 8 11 11
10 11 59 7 10 11 15 7 15 7 8 10 7 8 11
14 15 15 15 15 15 14 7 14 15 15 15 15 15 15
15 3 3 3 5 7 2 2 2 2 2 5 5 5 5
15 3 3 3 7 5 2 2 2 2 7 5 1 3 5
15 3 3 3 5 7 5 5 6 5 5 5 0 2 5
14 15 15 15 15 15 15 15 15 15 15 15 15 15 15
